2 2 2 2 2 2 2 2 2 2 2 2 1 2 2 2 2 2 2 2 2 2 2 2 2 2 2 2 2 2 2 2 2
2 0 0 0 0 5 0 0 0 0 0 0 0 0 0 0 0 0 0 5 2 0 0 0 0 4 1 0 0 0 0 0 2
2 0 2 0 2 0 2 2 2 2 2 2 1 2 2 2 2 2 2 0 2 0 0 0 0 0 0 0 0 0 0 0 2
2 0 2 0 2 0 2 5 0 0 0 0 0 0 0 0 0 5 2 0 2 0 0 0 0 0 0 0 0 0 0 0 2
2 0 2 0 2 0 2 0 2 2 2 2 1 2 2 2 2 0 2 0 2 0 0 0 0 0 0 0 0 0 0 0 2
2 0 2 0 2 0 2 0 2 5 0 0 0 0 0 5 2 0 2 0 2 0 0 0 0 0 0 0 0 0 0 0 2
2 0 2 0 2 0 2 0 2 0 2 0 2 2 1 2 2 0 2 0 2 0 0 0 0 0 0 0 0 0 0 0 2
2 0 2 0 2 1 2 1 2 1 2 1 1 1 2 1 2 1 2 1 2 0 0 0 0 0 0 0 0 0 0 0 2
2 0 2 0 2 1 2 1 2 1 2 1 1 1 2 1 2 1 2 1 2 0 0 0 0 0 0 0 0 0 0 0 2
2 0 2 0 2 4 2 4 2 4 2 4 4 4 2 4 2 4 2 4 2 0 0 0 0 0 0 0 0 0 0 0 2
2 0 2 0 2 0 2 0 2 0 2 2 2 2 2 0 2 0 2 0 2 0 0 0 0 0 0 0 0 0 0 0 2
2 0 2 0 2 0 2 0 2 5 0 0 2 0 0 5 2 0 2 0 2 0 0 0 0 0 0 0 0 0 0 0 2
2 0 2 0 2 0 2 0 2 2 2 2 2 2 2 2 2 0 2 0 2 0 0 0 0 0 0 0 0 0 0 0 2
2 0 2 0 2 0 2 5 0 0 0 0 2 0 0 0 0 5 2 0 2 0 0 0 0 0 0 0 0 0 0 0 2
2 0 2 4 2 0 2 2 2 2 2 2 2 2 2 2 2 2 2 0 2 0 0 0 0 4 1 0 0 0 0 0 2
2 0 2 5 2 5 0 0 0 0 0 0 2 0 0 0 0 0 0 5 2 0 0 0 0 0 0 0 0 0 0 0 2
2 0 2 2 2 2 2 2 2 2 2 2 2 2 2 2 2 2 2 2 2 0 0 0 0 0 0 0 0 0 0 0 2
2 0 2 0 0 0 0 0 0 0 0 0 0 0 0 0 0 0 0 0 0 0 0 0 0 0 0 0 0 0 0 0 2
2 0 2 0 0 0 0 0 0 0 0 0 0 0 0 0 0 0 0 0 0 0 0 0 0 0 0 0 0 0 0 0 2
2 0 2 0 0 0 0 0 0 0 0 0 0 0 0 0 0 0 0 0 0 0 0 0 0 0 0 0 0 0 0 0 2
2 2 2 2 2 2 2 2 2 2 2 2 2 2 2 2 2 2 2 2 2 2 2 2 2 2 2 2 2 2 2 2 2